111111111111111
100222222222001
101212121212101
122222222222221
121212121212121
122222222222221
121212121212121
122222222222221
121212121212121
122222222222221
121212121212121
122222222222221
101212121212101
100222222222001
111111111111111
